Tabel rezervari pentru cursa Cluj-Napoca -> Brasov 
din data 25/11/2011 cu plecare la ora 11:00

--------------------------------------------------
|   1 | eeeee                                    |
--------------------------------------------------
|   2 | ffffff                                   |
--------------------------------------------------
|   3 | ffffff                                   |
--------------------------------------------------
|   4 | ffffff                                   |
--------------------------------------------------
|   5 | ffffff                                   |
--------------------------------------------------
|   6 | ffffff                                   |
--------------------------------------------------
|   7 | ffffff                                   |
--------------------------------------------------
|   8 | ffffff                                   |
--------------------------------------------------
|   9 | ffffff                                   |
--------------------------------------------------
|  10 | ffffff                                   |
--------------------------------------------------
|  11 | ffffff                                   |
--------------------------------------------------
|  12 |                                          |
--------------------------------------------------
|  13 |                                          |
--------------------------------------------------
|  14 |                                          |
--------------------------------------------------
|  15 |                                          |
--------------------------------------------------
|  16 |                                          |
--------------------------------------------------
|  17 |                                          |
--------------------------------------------------
|  18 |                                          |
--------------------------------------------------
