Tabel rezervari pentru cursa Cluj-Napoca -> Oradea 
din data 28/11/2011 cu plecare la ora 6:30

--------------------------------------------------
|   1 | we                                       |
--------------------------------------------------
|   2 | we                                       |
--------------------------------------------------
|   3 | we                                       |
--------------------------------------------------
|   4 | we                                       |
--------------------------------------------------
|   5 | we                                       |
--------------------------------------------------
|   6 | we                                       |
--------------------------------------------------
|   7 | we                                       |
--------------------------------------------------
|   8 | we                                       |
--------------------------------------------------
|   9 | we                                       |
--------------------------------------------------
|  10 | we                                       |
--------------------------------------------------
|  11 | we                                       |
--------------------------------------------------
|  12 | we                                       |
--------------------------------------------------
|  13 | we                                       |
--------------------------------------------------
|  14 | we                                       |
--------------------------------------------------
|  15 | we                                       |
--------------------------------------------------
|  16 | we                                       |
--------------------------------------------------
|  17 | we                                       |
--------------------------------------------------
|  18 | we                                       |
--------------------------------------------------
|  19 | we                                       |
--------------------------------------------------
|  20 |                                          |
--------------------------------------------------
|  21 |                                          |
--------------------------------------------------
|  22 |                                          |
--------------------------------------------------
|  23 |                                          |
--------------------------------------------------
|  24 |                                          |
--------------------------------------------------
|  25 |                                          |
--------------------------------------------------
|  26 |                                          |
--------------------------------------------------
|  27 |                                          |
--------------------------------------------------
|  28 |                                          |
--------------------------------------------------
|  29 |                                          |
--------------------------------------------------
|  30 |                                          |
--------------------------------------------------
|  31 |                                          |
--------------------------------------------------
|  32 |                                          |
--------------------------------------------------
|  33 |                                          |
--------------------------------------------------
|  34 |                                          |
--------------------------------------------------
|  35 |                                          |
--------------------------------------------------
|  36 |                                          |
--------------------------------------------------
|  37 |                                          |
--------------------------------------------------
|  38 |                                          |
--------------------------------------------------
|  39 |                                          |
--------------------------------------------------
|  40 |                                          |
--------------------------------------------------
|  41 |                                          |
--------------------------------------------------
|  42 |                                          |
--------------------------------------------------
|  43 |                                          |
--------------------------------------------------
|  44 |                                          |
--------------------------------------------------
|  45 |                                          |
--------------------------------------------------
|  46 |                                          |
--------------------------------------------------
|  47 |                                          |
--------------------------------------------------
|  48 |                                          |
--------------------------------------------------
|  49 |                                          |
--------------------------------------------------
|  50 |                                          |
--------------------------------------------------
|  51 |                                          |
--------------------------------------------------
|  52 |                                          |
--------------------------------------------------
|  53 |                                          |
--------------------------------------------------
|  54 |                                          |
--------------------------------------------------
|  55 |                                          |
--------------------------------------------------
|  56 |                                          |
--------------------------------------------------
|  57 |                                          |
--------------------------------------------------
|  58 |                                          |
--------------------------------------------------
|  59 |                                          |
--------------------------------------------------
|  60 |                                          |
--------------------------------------------------
