Tabel rezervari pentru cursa Oradea -> Cluj-Napoca 
din data 28/11/2011 cu plecare la ora 18:30

--------------------------------------------------
|   1 | www                                      |
--------------------------------------------------
|   2 | www                                      |
--------------------------------------------------
|   3 |                                          |
--------------------------------------------------
|   4 |                                          |
--------------------------------------------------
|   5 |                                          |
--------------------------------------------------
|   6 |                                          |
--------------------------------------------------
|   7 |                                          |
--------------------------------------------------
|   8 |                                          |
--------------------------------------------------
|   9 |                                          |
--------------------------------------------------
|  10 |                                          |
--------------------------------------------------
|  11 |                                          |
--------------------------------------------------
|  12 |                                          |
--------------------------------------------------
|  13 |                                          |
--------------------------------------------------
|  14 |                                          |
--------------------------------------------------
|  15 |                                          |
--------------------------------------------------
|  16 |                                          |
--------------------------------------------------
|  17 |                                          |
--------------------------------------------------
|  18 |                                          |
--------------------------------------------------
