Tabel rezervari pentru cursa Oradea -> Arad 
din data 25/11/2011 cu plecare la ora 15:00

--------------------------------------------------
|   1 | bbb                                      |
--------------------------------------------------
|   2 | bbb                                      |
--------------------------------------------------
|   3 | bbb                                      |
--------------------------------------------------
|   4 | bbb                                      |
--------------------------------------------------
|   5 | bbb                                      |
--------------------------------------------------
|   6 | bbb                                      |
--------------------------------------------------
|   7 | bbb                                      |
--------------------------------------------------
|   8 | bbb                                      |
--------------------------------------------------
|   9 | bbb                                      |
--------------------------------------------------
|  10 | bbb                                      |
--------------------------------------------------
|  11 | bbb                                      |
--------------------------------------------------
|  12 | bbb                                      |
--------------------------------------------------
|  13 | bbb                                      |
--------------------------------------------------
|  14 | bbb                                      |
--------------------------------------------------
|  15 | bbb                                      |
--------------------------------------------------
|  16 | bbb                                      |
--------------------------------------------------
|  17 | bbb                                      |
--------------------------------------------------
|  18 | bbb                                      |
--------------------------------------------------
|  19 | bbb                                      |
--------------------------------------------------
|  20 | bbb                                      |
--------------------------------------------------
|  21 | bbb                                      |
--------------------------------------------------
|  22 | bbb                                      |
--------------------------------------------------
|  23 | bbb                                      |
--------------------------------------------------
|  24 | bbb                                      |
--------------------------------------------------
|  25 | bbb                                      |
--------------------------------------------------
|  26 | bbb                                      |
--------------------------------------------------
|  27 | bbb                                      |
--------------------------------------------------
|  28 | bbb                                      |
--------------------------------------------------
|  29 | bbb                                      |
--------------------------------------------------
|  30 | bbb                                      |
--------------------------------------------------
|  31 | bbb                                      |
--------------------------------------------------
|  32 | bbb                                      |
--------------------------------------------------
|  33 | bbb                                      |
--------------------------------------------------
|  34 | bbb                                      |
--------------------------------------------------
|  35 | bbb                                      |
--------------------------------------------------
|  36 | bbb                                      |
--------------------------------------------------
|  37 | bbb                                      |
--------------------------------------------------
|  38 | bbb                                      |
--------------------------------------------------
|  39 | bbb                                      |
--------------------------------------------------
|  40 | bbb                                      |
--------------------------------------------------
